10
25                   
                  ######
                  #    #
#######           #    #
#     #      +----/    #
#     #      |    #    #
#  @  /------+    ######
#     #                 
#     #                 
#######                 